{
  "levels": [
    {
      "name": "Starter",
      "rows": 8,
      "cols": 12,
      "grid": [
        "111111111111",
        "1M22222L2221",
        "133333333333",
        "144444444444",
        "100000000001",
        "1000S0W000001",
        "144444444444",
        "133333333333"
      ]
    },
    {
      "name": "Chaos",
      "rows": 9,
      "cols": 12,
      "grid": [
        "LLLLLLLLLLLL",
        "1M2M3M4M3M2M1",
        "1W0S0S0W0S0S1",
        "122222222221",
        "133333333331",
        "100000000001",
        "144444444444",
        "100000000001",
        "111111111111"
      ]
    },
    {
      "name": "Fortress",
      "rows": 9,
      "cols": 12,
      "grid": [
        "XXXXXXXXXXXX",
        "X0000000000X",
        "X0111111101X",
        "X0100000101X",
        "X01033M0301X",
        "X0100000101X",
        "X0111111101X",
        "X0000000000X",
        "XXXXXXXXXXXX"
      ]
    }
  ]
}
